#############################################################################
#S.......####################...............................................#
#######.##..........................................#.#.#.#.#.#.#.#.#.#.#.#.#
######..###########################################..#.#.#.#.#.#.#.#.#..##..#
#####..############################################...#######################
###...####################################..........#########################
##..##############################################...########################
#..################################################.#########################
#.#################################################..########################
#..............................................###..........................#
#.############################################.############################.#
#.......................#.#.##################.############################.#
#######################.###################################################.#
#######################..##################################################.#
#######################.##################################################..#
####################.....###############################################...##
#....................###################################################.####
##################.###################################################....###
#..................................................................######.###
#################################################################.#.......###
#################################################################...#########
##################################################################.##########
#E.................................................................##########
#############################################################################
